Map 1:
###################
#^0000000#00000000#
#0##0###0#0###0##0#
#0##0###0#0###0##v#
#00000000000000000#
#0##0#0#####0#0##0#
#0000#000#000#0000#
####=###0#0###=####
####0#0000000#0####
"0=0=#0#####0#=0=0"
####000#####000####
####=#0000000#=####
#0000#0#####0#0000#
#0##00000#00000##0#
#v0#0###0#0###0#0v#
##0#00000000000#0##
#0000#0#####0#0000#
#0####000#000####0#
#00000000>00000000#
###################

Map 2: